*****************
*               *
*   @           *
*               *
*               *
*****************
