************************************
*                                  *
*       |                          *			
*       |                         *
*                @                *
*                       |          *
*                       |          *
*     #                             *
*                                   *
*************************************


